11111111111111111111
1000101C00100C0E0001
10001011001111000001
10P01000000001110001
1000100011110000C001
10001C00100011111101
10001C00101000000101
10001C00101111110101
10000C00100000C10001
11111111111111111111