11111111111111111111
1000101C00100C0E0001
10001011001111111001
10P01000000001110001
1000100011100000C001
10001C00100000000001
10001C00100000000001
10001C00100000000001
10001C00100000000001
11111111111111111111