11111111111111111111
10P0100C000001E00001
10001000000001110001
1110000011100000C001
10000C00100000000001
11111111111111111111