11111111111111111111
10P0000C000000E00001
10000000000000000001
1000000000000000C001
10000C00000000000001
11111111111111111111