11111111111111111111
1000100C000001E00001
10000000000000000001
10P01000000001110001
1000000011100000C001
10000C00100000000001
11111111111111111111