X1111111111111111111
10P1C000000001000001
10011111100C01110001
10000010001001000001
10C100000110000001C1
Z1111111111111111111