11111111111111111111
10P10000000001000001
10011111100001110001
1000001000100100E001
10010000011000000101
11111111111111111111