11111111111111111111
10P1000C000001E00001
1001111110000111001
1000001000100100C001
10010C00011000000101
11111111111111111111