11111111111111111111
10P10000000001E00001
10011111100001110001
10000010001001000001
10010000011000000101
11111111111111111111