11111111111111111111
10P1000C000001E00001
10011111100001110001
1000001000100100C0001
10010C00011000000101
11111111111111111111